10 10
50 201 129 947 185 822 298 18 1027 260
1038 732 394 550 425 310 884 1414 1341 632
436 1245 1366 445 439 532 1084 1410 590 1005
1482 460 0 1439 546 838 837 808 1121 202
521 141 1003 1113 241 200 699 149 622 8
1316 1328 875 937 939 815 1105 335 1218 891
378 1235 1467 1452 37 1323 640 889 828 1018
486 687 1469 1032 144 364 1302 1051 561 107
768 402 1296 1113 475 417 0 906 877 547
480	264	837	535	1128 1059 673 347 1414 829
